afr	Afrikaans
ara	Arabic
ast	Asturian
aze	Azerbaijani
bak	Bashkir
bel	Belarusian
ben	Bengali
bos	Bosnian
bul	Bulgarian
cat	Catalan
ceb	Cebuano
ces	Czech
che	Chechen
cmn	Mandarin Chinese
cym	Welsh
dan	Danish
deu	German
ekk	Standard Estonian
ell	Greek, Modern
eng	English
epo	Esperanto
est	Estonian
eus	Basque
fao	Faroese
fas	Persian
fin	Finnish
fra	French
fry	Western Frisian
gle	Irish
glg	Galician
guj	Gujarati
heb	Hebrew
hin	Hindi
hrv	Croatian
hun	Hungarian
hye	Armenian
ind	Indonesian
isl	Icelandic
ita	Italian
jav	Javanese
jpn	Japanese
kan	Kannada
kat	Georgian
kaz	Kazakh
kir	Kirghiz
kor	Korean
lat	Latin
lav	Latvian
lit	Lithuanian
ltz	Luxembourgish
lvs	Standard Latvian
mal	Malayalam
mar	Marathi
mkd	Macedonian
mlt	Maltese
mon	Mongolian
mri	Maori
msa	Malay
nan	Min Nan Chinese
nds	German
nld	Dutch
nob	Norwegian
pes	Iranian Persian
plt	Plateau Malagasy
pnb	Western Panjabi
pol	Polish
por	Portuguese
pus	Pushto
ron	Romanian
rus	Russian
san	Sanskrit
sin	Sinhala
slk	Slovak
slv	Slovenian
som	Somali
spa	Spanish
sqi	Albanian
srp	Serbian
sun	Sundanese
swa	Swahili
swe	Swedish
tat	Tatar
tha	Thai
tur	Turkish
ukr	Ukrainian
vie	Vietnamese
war	Waray